2 13 31
###############################
#p * *2       *  ** * *      *#
# # # # #*# # #*# # # # # #*# #
#    * s *** **      b    **  #
# #*# # # # #1# #b#1# # # # #*#
#          *     **      *  **#
# # #*# # # # # #*#*#*#*# # # #
#   f    3   *   * *x* *      #
# # # # #*# # # # # # #*# #*# #
#   ****         *1           #
# # # # # # # # # #*# # # # #*#
#  ** *   *    2     4        #
###############################